######################################################################################. . . ######################              
######. . ########################################. ##########################. . . . . . . . . ##################.             
####. . ############################################. . ##########. . . ##################. . . . . . . . . . . . .           ##
##. ##########################. . . . . . . . . . . . . . ##. . . . . . . . . . .     . . . . . . . . . . . . . . . . . .     ##
##. ####################. . . . . . . . . . . . . . . . . . . . . . . . . . . . . . . . . . . . . . . . . . . . . . .         ##
####################. . . . . . . . . . . . . . . . . . . . . . . . . . . . . . .   . . . . . . . . . . . . . . . . . .      ##
##############. ##. . . . . . . . . . . . . . . . . . . . . . . . . . . . . . . . ##. . . . . . . . . . . . . . . . . . . .   ##. 
##############. . . . . . . . . . . ##########. ##########. . ############. ####. . ####. . . . . . . . . . . . . . . . . . ####
##########. . . . . . . . . . ##. . ##########. . ########. ##############. ####. . ####. . . . . . . . . . . . . . . . . . ####
############. . . . . . . ######. . . . . ######. . . . . . . . ##########. ####. . ####. . . . . . . . . . . . . . . . . . ####
##########. . . . . . . . ########. . . . . . . . ##. . . ####. . ######. . ####. . ####. . . . . . . . . . . . . . . . . . ####
########. . . . . . . . . ########. . . ##############. . ######. . . . . ######. . ####. . . . . . . . . . . . . . . . . . ####
########. . . . . . . . . . ########. . . . ##################. . . . . . ######. . . ##. . . . . . . . . . . . . . . . . . ####
########. . . . . ##. . . . . . ##. . . . . . . ######. . . . . . ######. . ######. . ####. . . . . . . . . . . . . . . . . ####
########. . . . ######. . . . . . . . . . . . . . . . . . . . . . ########. ####. . . ####. . . . . . . . . . . . . . . . . ####
####. . . . . . ######. . . . . . ##############. . . . ####. . . . ######. . . . . . . ####. . . . . . . . . . . . . . . . ####
####. . . . . . ##########. . . ##########. ######. . ####. . . . . . ####. . ######. . ####. . . . . . . . . . . . . . . . ####
####. . . . . ############. . . . ####. . . . . ##. . ####. . . ##. . ####. . ########. . . . . . . . . . . . . . . . . . . ##. 
####. . . . . ############. . . . ####. . . . . ##. . ######. ######. ####. ##########. .     . ####. . . . . . . . . . . . ####
##. ##. . . . ######. . ####. . . . . . . . . ####. . ############. . . . . ########. . . . .   ######. . . . . . . . . . ##. ##
######. . . . ######. . . ##. . . . . . . . . ####. . . . . . . . . . ##. . ######. . . . . . . . ##################. . . ######
######. . . . ####. . ##. ####. . . . . . . ########. . . . . . . . . ##. . . . . . . . . . . . . . . . ############. .   ######
######. . . . . . . . ##. . ##. . . . . . . . ##. ##. . . . . ##. . . ######. . . . . . . ########. . . . . . . . ##      ######
####. . . . . . ####. ####. ##. . . . . . . . . . . . . . . ####. . . ######. . . . . . . ############. . . . . . . . . . ######
##. . . . . . ######. ####. . . ####. . . . . . . . . . . . . ############. . . . . . . ##############. . . . ##. . . . . ######
##. . . . . . ####.   ####. . . ########. . . . . . . . ####. . . ######. . . . . . . . . . . . . ####. . ########. . . . ######
######. . . . ####. . ######. . ##########. . . . . . . . ####. . . ##. . . . . . ####. . . ##. . . ####. . ######. . . . ######
######. . . . ##. . . ######. . ######. . . ######. . . . . ####. . . . . . . .   ####. . ##. . . . . ##. . ######. . . . ######
##. ##. . . . ####. . . . . . . . ####. . ##########. . . . . . . . . . . . .   ######. . ##. . . . . ####. ######. . . . ######
######. . . . . ########. . . . . . ##. . ############. . . . . . . . . . . . ########. . ########. . ##. . ######. . . . ######
######. . . . . . . ####. . . . . ####. . . . . . ######. . . . . . . . . . . ########. . . ####. . . . . . ######. . . . ######
######. . . . . ##. . . . . ##########. . . . . . . ######. . . . . . . ##. . . ######. . . . . . . . . . . ######. . . . ######
######. . . . ######. . . . . . . . . . . ########. . . . . . . . . . . ####. . . . . . . ############. . ##. . ##. . . . ######
####. . . . . ########. ##. . . ######. . ########. . . . . . . . . . . . ####. . . . . . ####. . ##. . ######. . . . . . ######
######. . . . ######. . ##. . ##. ######. . ########. . . . . . . . . . . ############. . ####. . . . . . ########. . . . ######
####. . . . . ######. . ##. . . . . ####. . ######. . . . . . . ####. . . . ##########. . ####. . . . . . . . . ##. . . . ######
######. . . . ######. . ####. . . . ####. ######. . . . . . . . ######. . . . . ####. . . ######. . ######. . . ##. . . . ######
. ##. . . . . ########. ######. . ####. . ####. . . . . . . . . . ######. . . . . . . ##########. . . ######. . ##. . . . ######
##. ##. . . . ########. . ######. . . . . . . . . . . . ######. . . . ##. . . . . . . . . ########. . ######. ####. . . . ######
##. ##. . . . . ##. ##. . ##############. . . . . . . ############. . . . . . . . . . . . . ##. . . . ######. ####. . . . ######
##. ##. . . . . . . . . . . ############. . . . . . ######. . . ####. . . . ##. . . . . . . . . . . . . ##. . ##. . . . . ######
##. ##      ######. . . . . . . ######. . . . . . . . ####. . . . ##. . . . ########. . . . . . . ##. . ##. . . . . . . . ######
##. ##. . . ############. . . . . . . . . . . . . . . . ##. . . . . . . . . ########. . . . . . . ####. ##. . ####. . . . ######
##. . . . . ####. . ##########. . . . . . . . ####. ##. . . . . . . ####. . . ####. . . . . . . . . ##. . . . ####. . . . ######
##. . . . . . . . . . . . ########. . . . . ########. . . . . . ##########. . ####. . . . ####. . . ####. . . ####. . . . ######
####. .   . . . . . . . . . ######    . . ##########. . ##. . ############. . ####. . . . ####. . . . ############. . . . ######
. ##. . . . . . . . . . . . . . . .   . . . . ######. ####. . ##. . . ####. . . ##. . . . ######. . . ############. . . . ######
####. . . . . . . . . . . . . . . .   ##. . ######. . ####. . . . . . ####. . . ################. . . . ##########. . . . ######
####. . . . . . . . . . . . . . . .   ##. . . . . . . ######. . . . . . . . . . . ##########. . . . . . ##########. . . . ######
####. . . . . . . . . . . . . . . . . ##. . . . ####. ########. . . . . . . . . . . . ####. . . ##. . . . ########. . . . ######
. ##. . . . . . . . . . . . . . . . . ####. . . ####. . ######. . . . . . ########. . . . . . ######. . . . ####. . . . . . ####
. . . . . . . . . . . . . . . . . . . . ##. . . ######. . . . . . ####################. . . . ######. . . . . . . . . . ########
##. . . . . . . . . . . . . . . . . . . ####. . ######. . . . . . ####. . . ##############. . ########. . . . . . . . . ########
####. . . . . . . . . . . . . . . . . . ####. . ####. . ######. . . ##. . . . . . . . . . . . . ########. . . . . . . ##########
. ##. . . . . . . . . . . . . . . . . . ####. . . ##. ##########. . . . . . . . . ######. . . . ########. . . . . . . ##########
. ##. . . . . . . . . . . . . . . . . . ##. . . . ##. ##############. . ######. . ##########. . ######. . . . . . . . ##########
. ##. . . . . . . . . . . . . . . . . . ######. . ##. ##############. . ##. ####. ############. . . . . . . . . . . ############
####. . . . . . . . . . . . . . . . . . . . . . . . . . . . . . . . . . . . . . . . . . . . . . . . . . . . . . ################
##      . . . . . . . . . . . . . . . . . .   . . . . . . . . . . . . . . . . . . . . . . . . . . . . . . . ####################
##    . . . . . . . . . . . . . . . . . . .   . . . . . . . . . . . . . . . . . . . . . . . . . . . . . ########################
##        . . . . . . . . . . . . . . . . ####. . . . . . ####. . . . . . . . . ##. . . . . . ########. ####################. ##
##          . . . . . . . . . . . . . ##################. . . ##. . ##. . ##############. ################################. ####
.                 . . . . ########. ########################################. ##########################################. ######
. . . . . . . ##. ################################################################. . ##########. . . ##########################
